###########         #
########### ####### #
###      #  #     # #
B   ####   ## ### # #
###########A#  ## # #
            ## ## # #
# ### ### #    ## # #
# ### ### ### ###   #